10 20
|------------------|
|#...|@...........*|
|..--|...---|....|.|
|...*|......|....|.|
|..--|......|#...|.|
|....|.---------.|.|
|..--|..#|..*|...|.|
|....|---|.--|---|.|
|.................#|
|------------------|
