10 20
|------------------|
|#...|@...........*|
|..--|...---|....|.|
|....|......|....|.|
|..--|......|....|.|
|....|.---------.|.|
|..--|...|..*|...|.|
|....|---|.--|---|.|
|.................#|
|------------------|
